Mapa completo
11111111111111111
10022232233333321
10131213121212131
13332232323323231
13131212131312121
13232223322322331
12131213121313131
12322332232323221
13121212131213131
13333223322233321
13131312131313121
12222322322232221
13131212131213101
13333223232232001
11111111111111111
