Mapa completo
11111111111111111
10032322222222321
10131212131212121
12333222233223321
12131212131213131
12222222222223231
13131312121213131
13222322333323331
13131313121313131
13332332323333221
13121312131313121
12222332332223231
12131212121213101
12333222232232001
11111111111111111
